########
#.#....#
#....#.#
#....#.#
#......#
#...####
##.....#
########